11111111111111111111111
10010E00000000000010001
10100000000000000W00001
1100N000110000010000001
11111111111111111111111